111111111111111111111111111111
100000000000000C00001000000001
100000000000000C00001000000001
100000000000000C00001000000001
1000000000E0000000000000P00001
100000000000000C00001000000001
111111111111111111111111111111